'    //    D     //  '
'   ///         ///  '
'       ///          '
'               /////'
'    /////   ///     '
'         ///////////'
'                    '
'/////   ////   //// '
'                    '
'            //////  '
'    ///     ///     '
' //////             '
'            /////   '
'  //////    ///     '
'        ////        '
'                    '
'//////////      ////'
'             ///////'
'   //////           '
'  ////     S     ///'