
'          D     //  '
'   ///////////////  '
'       ///          '
'               /////'
'///////     ////////'
'         ///////////'
'                    '
'////////////   //// '
'                    '
'            //////  '
'    ///     ///     '
' //////             '
'            /////   '
'  //////    ///     '
'        ////        '
'                    '
'//////////      ////'
'             ///////'
'   //////           '
'S ////           ///'
